metal
#K######T
XXX####XX
#########
########H
#########
#########
########H
########X
#XX####X#
#########
#######X#
######X##
####XX###
#########
#####H###
T########  
XX#######
##X##H###
###XX####
#####H###
#####X#X#
#########    
#######H#
#########
#########
#######H#
#########
#######HX
######XX#
#####X###
####X####
O##X#####	
XXX######
